1111111111111111
1000000P00000001
1000X0000000E001
1CCCCCCCCCCCCCC1
1111111111111111
