111111111
100P00E01
10000C00
100000001
111111111
