1111111111111111
1000000P00000001
100000000000E000
1CCCCCCCCCCCCCC1
1111111111111111
